#######################################################################
#A#             #       #       #               #   #     #     #     #
# # ##### ### ### # ### # ##### # ######### ### # # ### # ### # ### # #
# # #   #   #     # #   # #   # # #   #     # # # #     #   # #     # #
# ### # ### ####### ### ### # # # # ### ##### # # ######### # ####### #
#     #   # #     #   #     # #   #   # #   #     #         # # #     #
######### # # ####### ####### # ### # # # # ##### ####### ### # # #####
#       # #   #       #   #   #   # # #   #     # #     # #   #   #   #
# ##### # # ### ####### ### ##### ### ######### # # ### # # ####### # #
#     # # # #   # #         #   # #     #     # # # #   #   #       # #
##### # # ### ### # ######### # # # ### ### ### ### # # ##### ####### #
#     # #     # #   #       # # #   # #   # #   #   # # #   #       # #
##### # ####### # ### ##### # # ##### ### # # ### ### ### # ### ##### #
#   # #   #       #   #     # #             #     # #   # #   # #     #
# # # # ### ####### ### # ### ################# ### ### # ### # # #####
# # # #   #       #   # # #       #           #       #     #   # #   #
# # # ### ####### ### # ### ####### ######### ##### ############# # # #
# # #   #       #   # # #     #   #   #     #   #   #       #     # # #
# # ####### ### ### # # # ##### # ### # ### ### ##### ##### # ##### # #
# #   #     # # # # # # # # #   #     # # #   #       # #   # #     # #
# ### # ##### # # # # # # # # ######### # # ########### # ### # ##### #
# #     #         # # #     #         #   #     #       #   #   #   # #
# ### ########### # # ############### ### ##### # # ### ### ##### # # #
#   # #   #     # # #     #         #   # #   #   #   #   #       #   #
# # # # # # ### # # ####### ####### ### # # # ####### ############### #
# # # # # #   # # # #       #   # #     # # # #     #       #       # #
### # # # ### # ### # ####### # # ####### # ### ### ####### # ##### # #
#   # # #   # #   # # #       #     #   # # #   # #     # # # #   # # #
# ##### # ### ### # # # ### ####### # # # # # ### ### # # # # ### # # #
#   #   #   # # # # # #   #       #   # # # #     #   #   # # #   # # #
### # ##### # # # # # ##### ##### ####### # ### ### ##### # # # ### # #
#   # #   # #   # # #     # #   #   #     #   # #   #   # #   #   #   #
# ### # # # ### # # ##### # ### ### # ##### ### # ##### # ##### # #####
#     # #     # #   #   # #       # #   #     # # #   #   #     #     #
####### # ##### ##### # # ####### # ### # ### # # # # ### # ##### ### #
#       # #     #     #   # #     #   # #   #   # # #   # # #   #   # #
# ####### # ######### ##### # ####### # ### ##### # ### ### # # ### # #
# #       # #         #     #     # #   #       #     #     # #   # # #
# ##### ### ##### ######### ##### # ########### ############# ### ### #
# #   #   #       #         #   # #         #       #   #   # # # #   #
# # # ############# ####### # # # ##### ### # ####### # # # # # # # ###
# # #               #   #   # # #       #   #   #   # #   #   # # #   #
# # ########### ##### # # ### # ######### ####### # # ######### # ### #
# #       # #   #     #       # #       #       # # #     #     #   # #
# ####### # # ################# # ############# # # ##### ##### ### # #
# #       # #     #   #   # #   #           #   # # #     #   #       #
# # ####### ##### # # # # # # ### ##### ### # ### # # ##### # #########
# # #   #       #   #   # # #   #   #   #   #     # #       #         #
# # # # # ##### ######### # ### # ### ### ######### ### ############# #
# #   # #     # #         # #   # #   #   #       #   # #       #   # #
# ##### ##### ### ######### # ##### ####### # ####### # ### ### # # # #
#       #   #   # #       #   #     #       # #       #   #   #   # # #
# ####### # ### # ### ### # ### ##### ####### # ######### ######### # #
#         # #   #   #   #       #     #     # # #       #       #   # #
########### # ##### ### ####### # ##### ### # # # # ### ####### # # # #
#         #   #     #     #   # # #   # #     # # # #   #     #   # # #
# ### # ### ### ### ####### # ### # ### ##### # ### ### # ### ### ### #
# #   # #   #   #   #       #     #   #   #   #   #   # #   #   # #   #
# # ### # ### ##### # ############### ### ### ### ### # ### ### # # ###
# # #   # # # #   # #   #   #           #   #   #     #   # # #   #   #
# # ### # # # # # # ### # ### # ####### ### ############# # # ####### #
# #   # #   #   # # #   # #   # #     #   #             # #       #   #
# ### # ### ##### ### ### # ### # ##### ######### ####### ####### # ###
# #   # # # #   #   # #     #   #     # #   #     #   #   #   #   #   #
### ### # # # # ### # ####### ### ### # # # # # ### # # ### ### ##### #
#   #     #   # #   # #     # # #   #   # #   # #   # #   #     #   # #
# # ##### ##### # ### # ### # # ### ##### ### ### ### ### ### ##### # #
# # #   # #   # # #   # # #   #   # #   #   # #   #     #   #       # #
# ### # ### # # # # ### # ##### ### # # ### ### ### ####### ######### #
#     #     #   #       #             #   #       #                  B#
#######################################################################
