#############
#A#   #     #
# ### # ### #
#   #     # #
### ### ### #
# #   # #   #
# ### # # # #
#     # # # #
# ####### # #
# #       # #
# ##### ### #
#       #  B#
#############