#########################################
#A    #       #         #             # #
##### # ##### # ### # ### ######### # # #
#   # # #   # #   # # #   #   #     #   #
# # # # # # # ### # ### ##### # ####### #
# # #   # # #   # # #   #   # # #       #
# ####### # ### # # # ### # # # ##### ###
#       # #   # # # # #   #   #     #   #
### ### ### ### # # # ### ### ##### ### #
#   #       #   # #     # #     #   #   #
# ####### ### ### ##### # # ##### ### ###
# #     # #   # # #   #   #   #   #     #
# # ### ### ### # # # ####### # ####### #
#   # #     # #   # #       # #     #   #
# ### ####### # ### ####### ####### # ###
# #   #   #     #   # #     #       #   #
# # # # # ####### ### # ##### ######### #
# # # # #       #   # #   #   #     #   #
# # # # ####### ### # ### # ### # ### ###
#   #   #           #       #   #      B#
#########################################
