###############################################################################
#A#   # #   #           #                 #               #                 # #
# # # # # # # ####### ### ##### ######### # ########### # # ########### ### # #
#   # #   #     # #   #   #   # #     #   # #         # #   #         # # #   #
##### # ####### # # ### ### # # ##### # ### # ####### ####### ####### # # ### #
#   # # #   #     # #   #   # #   #   # #   #       #       # #   #   # #   # #
# ### # # # # ##### # ### ####### # # # ### ####### ####### # ### # ### # ### #
# #   # # # # #     #   # #   #   # # #   # #     # #     # #   # # #   #     #
# # ##### # ### ### ### # # # # ### ##### # ### ### # # ### ### # # # ####### #
# # #     #   # # # #   # # #   #   #   # #     #   # #         #   #       # #
# # # # ##### # # # # ### # ##### # # # # ##### # ############### ####### # ###
#   # #   #   # #   #     # #   # #   #   #   # # #       #             # #   #
# ####### # ### ####### ### # ### ######### # ### # ##### ##### ####### ##### #
#       # #   # #       #   #   # #   #     #   #     # #     # #     #     # #
####### # ### # # ####### ##### # # # ### ##### ##### # ##### ### ### ##### # #
#       # #   #   #     #   #   #   #     #   #     # #     #       # #   #   #
# ####### # ### ### ####### # ############# # ##### # ##### ######### # # ### #
# #       # # # #   #     # #       #     # #   #   #       #   #     # #   # #
# ### ### # # # # # # ### # # ##### # # ### ### # ########### # # ##### ##### #
#   # #   # # #   # # #     #     # # #     #   #       #     # # #     #     #
### # # ### # ##### # ########### # # ####### ######### # ##### # ##### # #####
#   # #   # #       #   #       # # #   # #   #   #   #   #   # # #     # #   #
# ####### # # ##### ### # ####### # ### # # ### # # # ####### # # # ### # ### #
#         # # #   # #   #         #   #   #     #   #         #   #   # #   # #
########### ### # ### ### ########### ### ######### # ####### ##### # ##### # #
#     #   # #   #   # #   #     #   #   # #       # # #   #   #     # #   #   #
# ### ### # # ##### # # ####### # # # ### # ##### ### # ### ### ##### # # ### #
# # # #   # # #   # # #         # #   #   # #   # #   #     #   #   #   # #   #
# # # # # # # # # # # ########### ##### ### # ### # ##### ### ##### ##### # ###
# #   # # # #   # #   #         # #   #   # #     #     # # # #       # #   # #
# # ### # # ##### ##### ####### # # # ### # # ##### ### # # # # ##### # ##### #
# #   # # #     # #     # #   # #   #   # # #     # #   #   #   #   # # #     #
# ### # # ##### # # ### # # # # ####### # # ##### ### # ######### ### # # # ###
#   #   #     # # #   # #   # #       #   # #   #     # #           # #   #   #
# # ######### # # # ### ##### ####### ##### # ######### # ######### # ##### # #
# #   #     # # # # #   #   # #       #     # #         # #   #     #     # # #
# ### ##### # # # # # ### # # # ####### ##### # ######### # ### ### ##### ### #
#   #   #   # # # # # #   # # #     #   #     #       # #   #   #   #   # #   #
####### # ### # # # # # # # # ##### # ### ### ####### # # ### ### ### # # # # #
#     # #     #   # # # # #   #     #   # #       #     # #   #   #   # #   # #
# ### # ### ####### # # # ##### ####### # ##### ### ##### # ### ### ### ##### #
# #   #   #     #   # # #               #     # #   #   # # #     #   #     # #
# ### ### ##### ##### # ########### ##### ### ### ### # # # ##### ### # ##### #
#   #     #   #     # # #     #   # #   #   #     #   #   #   # # #   # #     #
# # ####### # ##### # ### ### # # ### # ########### ######### # # ##### # #####
# # #   #   # #     #       #   # #   #   #         #       # # #       #     #
### # # # ##### ##### ########### # ##### # ######### # ##### # # ########### #
#   # #   #   # #   # #         # # #   # # # #   #   # #     # # #         # #
# ### ##### # # # # # # ####### # # # # # # # # # # # ### ##### # # ##### ### #
# # #   #   # # # # # # #   #     #   # # # #   #   #   #   #   # #     #   # #
# # # # # ### # # # # # # # # ######### # # ##### ##### ### # ### ##### ### # #
# #   #   #   # # #   #   # # #         # #     # #       # # #   #   #   #   #
# ### ##### ### ##### ##### ### ######### ##### ### ##### # # # ### # ### #####
#   #     #     #   #   #   #   #         #   #     #     # # #     #   # #   #
# # ##### ####### # ##### ### ### ####### ### ####### ##### # ######### # # ###
# # #     #       #     #       #   # #       #     #   #   #       #   # #   #
### # ######### # ##### # ######### # # ####### # ##### # ##### ### # ### ### #
#   #   #     # # #   # # #     #   #   #       #     # # #   #   # # #   #   #
# ##### # ### ### ### # ### ### # ####### ########### # # # # # # # # # ### # #
# #   # # # #   #   #   #   #     #       #     #     # # # # # # # # #     # #
# # # # # # ### # # ### # # ####### ######### # # ##### # # # ### # # ####### #
#   # #   # #   # #   #   # #       #         # #       #   # #   # #       # #
# ### ##### # ####### # ##### ####### # ##### ############### # ##### ####### #
# # #   #   # #       # #   # #   #   # #   # #         # #   #   #   #       #
# # ### # ### # ######### # # # # # ### # ### # # ##### # # ### # # ### #######
#     # #   # #       #   #   # #     # # #   # # #   # # # #   #   # #   #   #
##### # ### # ####### # ####### ####### # # ### # # # # # # ### ##### ### # # #
#     #   #     #     # #     #     #   #   #   #   # #   #   #       #   # # #
# ####### ##### # ##### # ####### ### ##### # ####### ### ### ####### # ##### #
#   #   #     #   #   # #   #     #   #   # #   #     #   #   #     # #     # #
### ### ##### ### # # # ### # ##### ### # ##### # ##### ### # # ### ####### # #
# # #   #   # #   # # #   #   #   #     #     # #     # #   # # # #       #   #
# # # # # ### # ### # ### ### # # # ######### # ##### # # ##### # ##### ##### #
#   # # # #   #   # #   #   # # # #         # # #   # # #   #   #     #     # #
# ### # # # ####### # ##### ### # ########### # ### # ##### # ### ### ### ### #
#     # # #         # #     #   #   #   #   #       #     # # #     #   #   # #
####### # ########### # ##### ##### # # # # ########### # # # ##### ### ### # #
#                   #         #       #   #             # #         #     #  B#
###############################################################################
